WWWWWWWWWWWWWWWWWWWWWWWWWWWWWWWWWWWWWWWW
W.r..r..w.r...d.w...e.r.wr......w..rr..W
W.......w......rwee.e...we..d...w....r.W
WeeeeeeeeeeeeeeeeeeeeeeeeeeeeeeeeeeeeeeW
Wd......w.r....rw.r.e..ew..r..d.w..r.r.W
W.......w.r....rw.r.er..w.....r.w...e..W
WwwwwwwwwwwwwwwwwwwwewwwwwwwwwwwwwwwwwwW
W....rr.w..r....w...e..rw....r..w.....rW
W.......w..e....w...e...w....r.ew.....rW
WeeeeeeeeeeeeeeeeeeeeeeeeeeeeeeeeeeeeeeW
Wr..r...w....r..w..re...w......dwr.....W
Wr....r.w..r..r.w...e.erw.......wr...r.W
W.r.....w...r...w...e.erw.......wer..r.W
WwwwwwwwwwwwwwwwwwwwewwwwwwwwwwwwwwwwwwW
Wr.eq...w...r.r.w...e...w.rd..r.w......W
W.....r.wr......w..de...we..r...w.r.rr.W
WeeeeeeeeeeeeeeeeeeeeeeeeeeeeeeeeeeeeeeW
Wd..e.r.wr....r.w.r.e..rw.r.r...w......W
W.....r.wr..d...w...er..w..r....w...rreW
W.d...erw..r....w.Xder..w.e.....w...rreW
W.r....ew..e..r.w.P.e...w....r.rw....e.W
WWWWWWWWWWWWWWWWWWWWWWWWWWWWWWWWWWWWWWWW